21,17,13,13,13,13,13,13,13,13,18,21,21,21,21,21,17,13,13,13,13,18,21,21,21
21,11,03,06,03,00,05,05,05,04,14,18,21,21,21,17,12,00,00,00,00,14,13,18,21
21,16,09,09,09,09,10,07,03,00,01,22,21,21,17,12,00,00,07,00,00,00,00,14,18
21,21,21,21,21,21,16,10,00,06,05,22,21,21,11,00,00,00,08,06,00,00,00,00,22
17,13,13,13,13,13,18,11,01,02,08,22,21,21,11,04,00,00,15,10,06,06,00,00,22
11,00,00,00,00,00,22,11,01,00,07,22,21,21,11,00,03,00,22,11,07,00,00,00,22
11,00,06,01,02,00,14,12,06,06,06,14,13,13,12,00,00,00,22,11,08,00,00,00,22
11,00,00,00,00,00,00,00,00,00,00,04,05,00,07,00,05,00,22,11,00,00,00,00,22
11,07,00,15,10,00,00,01,00,02,03,00,00,00,08,00,00,00,22,16,10,07,00,00,22
11,08,01,22,11,00,00,00,00,15,09,10,00,00,03,04,00,00,14,18,11,08,00,00,22
11,03,02,22,16,10,00,00,00,14,18,16,10,00,00,00,00,00,00,22,11,00,00,00,22
11,20,00,22,21,16,10,06,06,06,14,18,16,10,01,02,00,00,00,22,11,00,00,00,22
11,00,07,14,13,18,11,00,03,00,00,14,13,12,02,00,00,00,15,19,11,06,06,06,22
11,00,08,03,00,22,11,00,00,00,00,00,00,00,07,05,06,00,22,17,12,00,00,15,19
11,00,00,00,00,22,16,10,00,00,07,00,00,00,08,00,00,15,19,11,00,00,00,22,21
16,10,00,00,00,14,18,11,00,00,08,00,00,00,00,15,09,19,17,12,00,00,00,22,21
21,16,10,06,06,06,22,11,00,00,06,06,06,06,00,22,17,13,12,00,00,00,00,22,21
21,21,11,00,00,00,22,16,10,00,00,00,00,00,15,19,11,00,00,00,00,00,00,22,21
21,21,11,00,00,15,19,21,16,09,09,09,09,09,19,21,11,00,00,00,00,15,09,19,21
21,21,16,09,09,19,21,21,21,21,21,21,21,21,21,21,16,09,09,09,09,19,21,21,21

1,1,1,1,1,1,1,1,1,1,1,1,1,1,1,1,1,1,1,1,1,1,1,1,1
1,1,0,0,0,0,0,0,0,0,1,1,1,1,1,1,1,0,0,0,0,1,1,1,1
1,1,1,1,1,1,1,0,0,0,0,1,1,1,1,1,0,0,0,0,0,0,0,1,1
1,1,1,1,1,1,1,1,0,0,0,1,1,1,1,0,0,0,0,0,0,0,0,0,1
1,1,1,1,1,1,1,1,0,0,0,1,1,1,1,0,0,0,1,1,0,0,0,0,1
1,0,0,0,0,0,1,1,0,0,0,1,1,1,1,0,0,0,1,1,0,0,0,0,1
1,0,0,0,0,0,1,1,0,0,0,1,1,1,1,0,0,0,1,1,0,0,0,0,1
1,0,0,0,0,0,0,0,0,0,0,0,0,0,0,0,0,0,1,1,0,0,0,0,1
1,0,0,1,1,0,0,0,0,0,0,0,0,0,0,0,0,0,1,1,1,0,0,0,1
1,0,0,1,1,0,0,0,0,1,1,1,0,0,0,0,0,0,1,1,1,0,0,0,1
1,0,0,1,1,1,0,0,0,1,1,1,1,0,0,0,0,0,0,1,1,0,0,0,1
1,0,0,1,1,1,1,0,0,0,1,1,1,1,0,0,0,0,0,1,1,0,0,0,1
1,0,0,1,1,1,1,0,0,0,0,1,1,1,0,0,0,0,1,1,1,0,0,0,1
1,0,0,0,0,1,1,0,0,0,0,0,0,0,0,0,0,0,1,1,1,0,0,1,1
1,0,0,0,0,1,1,1,0,0,0,0,0,0,0,0,0,1,1,1,0,0,0,1,1
1,1,0,0,0,1,1,1,0,0,0,0,0,0,0,1,1,1,1,1,0,0,0,1,1
1,1,1,0,0,0,1,1,0,0,0,0,0,0,0,1,1,1,1,0,0,0,0,1,1
1,1,1,0,0,0,1,1,1,0,0,0,0,0,1,1,1,0,0,0,0,0,0,1,1
1,1,1,0,0,1,1,1,1,1,1,1,1,1,1,1,1,0,0,0,0,1,1,1,1
1,1,1,1,1,1,1,1,1,1,1,1,1,1,1,1,1,1,1,1,1,1,1,1,1